"filename", "language", "Markdown", "C++", "Python", "HTML", "comment", "blank", "total"
"c:\Users\Matthew Champagne\OneDrive\Personal Projects\Computer Project\Assembler\Assembler.cpp", "C++", 0, 354, 0, 0, 58, 97, 509
"c:\Users\Matthew Champagne\OneDrive\Personal Projects\Computer Project\Assembler\main.cpp", "C++", 0, 54, 0, 0, 0, 10, 64
"c:\Users\Matthew Champagne\OneDrive\Personal Projects\Computer Project\Computer\Assembler.cpp", "C++", 0, 354, 0, 0, 58, 96, 508
"c:\Users\Matthew Champagne\OneDrive\Personal Projects\Computer Project\Computer\Assembler.h", "C++", 0, 96, 0, 0, 14, 15, 125
"c:\Users\Matthew Champagne\OneDrive\Personal Projects\Computer Project\Computer\Computer.ino", "C++", 0, 46, 0, 0, 2, 17, 65
"c:\Users\Matthew Champagne\OneDrive\Personal Projects\Computer Project\Computer\Disassembler.cpp", "C++", 0, 299, 0, 0, 47, 76, 422
"c:\Users\Matthew Champagne\OneDrive\Personal Projects\Computer Project\Computer\LCDDisplayAndKeyboard.cpp", "C++", 0, 203, 0, 0, 1, 26, 230
"c:\Users\Matthew Champagne\OneDrive\Personal Projects\Computer Project\Computer\LCDDisplayAndKeyboard.h", "C++", 0, 11, 0, 0, 16, 3, 30
"c:\Users\Matthew Champagne\OneDrive\Personal Projects\Computer Project\Computer\Memory.cpp", "C++", 0, 158, 0, 0, 50, 42, 250
"c:\Users\Matthew Champagne\OneDrive\Personal Projects\Computer Project\Computer\Memory.h", "C++", 0, 41, 0, 0, 2, 14, 57
"c:\Users\Matthew Champagne\OneDrive\Personal Projects\Computer Project\Computer\MemoryController.cpp", "C++", 0, 104, 0, 0, 9, 36, 149
"c:\Users\Matthew Champagne\OneDrive\Personal Projects\Computer Project\Computer\MemoryController.h", "C++", 0, 20, 0, 0, 2, 5, 27
"c:\Users\Matthew Champagne\OneDrive\Personal Projects\Computer Project\Computer\Processor.cpp", "C++", 0, 219, 0, 0, 72, 30, 321
"c:\Users\Matthew Champagne\OneDrive\Personal Projects\Computer Project\Computer\Processor.h", "C++", 0, 16, 0, 0, 1, 4, 21
"c:\Users\Matthew Champagne\OneDrive\Personal Projects\Computer Project\Disassembler\main.cpp", "C++", 0, 31, 0, 0, 0, 9, 40
"c:\Users\Matthew Champagne\OneDrive\Personal Projects\Computer Project\Documentation\MIPS Quick Tutorial.html", "HTML", 0, 0, 0, 576, 2, 35, 613
"c:\Users\Matthew Champagne\OneDrive\Personal Projects\Computer Project\README.md", "Markdown", 2, 0, 0, 0, 0, 1, 3
"c:\Users\Matthew Champagne\OneDrive\Personal Projects\Computer Project\TestProgram\Test.cpp", "C++", 0, 10, 0, 0, 0, 7, 17
"c:\Users\Matthew Champagne\OneDrive\Personal Projects\Computer Project\TestProgram\fileParse.py", "Python", 0, 0, 6, 0, 0, 2, 8
"Total", "-", 2, 2016, 6, 576, 334, 525, 3459